bbbbbbbbbbbbbbbbbbbbbbbbb
b..@....................b
b...n......#............b
b................#......b
b........#..............b
b.......................b
b.......................b
b...#...................b
b...........#....g......b
b.......................b
b...#.....#.............b
b.......................b
bbbbbbbbbbbbbbbbbbbbbbbbb